#SIZE:14x14
#PLAYER1:4,7,b
l l l l l l l l l l l l l l 
l g l l l l l l l l l l g l 
l l l l l l l l t l l l l l 
l l l l l l b l l l l l l l 
l l l l l l t l l l l l l l 
l l l l l l l l l l l l l l 
w w h h w w w w w w h h w w 
w w h h w w w w w w h h w w 
l l l l l l l l t l l l l l 
l l l t l l l l l l l l l l 
l l l l l l b l l l l l l l 
l l l l l l l l l l l l l l 
l g l l l l l l l l l l g l 
l l l l l l l l l l l l l l 