#10x10

l l l l l l t l l l 
l g l l l l l l g l 
l l l l t l l l l l 
l l l l l l l l t l 
w w h w w w w h w w
w w h w w w w h w w
l l l l l t l l l l 
l l t l l l l l l l 
l g l l l l l l g l 
l l l l l l l l l l 
